NO ./textures/N/BRICK_2B.PNG
SO ./textures/S/BRICK_3B 12.41.24 AM.PNG
WE ./textures/W/BRICK_3D 12.41.24 AM 12.41.32 AM.PNG
EA ./textures/E/BRICK_1A.PNG

F 50,50,50
C 135,206,235

11111111111
10000000001
1000N000001
10001D10001
10001010001
10001D10001
10000000001
11111111111
