NO ./textures/N/BRICK_2B.PNG
SO ./textures/S/BRICK_3B 12.41.24 AM.PNG
WE ./textures/W/BRICK_3D 12.41.24 AM 12.41.32 AM.PNG
EA ./textures/E/BRICK_1A.PNG

F 0,0,0
C 135,206,235

111111111111111
111111000000001
111111111111111
111100000001111
111000000000111
1100000110000011
100001111100001
110000111000011
111000010000111
111100000001111
111110010011111
1111111N1111111
111111111111111
d	
