NO ./textures/N/BRICK_2B.PNG
SO ./textures/S/BRICK_3B 12.41.24 AM.PNG
WE ./textures/W/BRICK_3D 12.41.24 AM 12.41.32 AM.PNG
EA ./textures/E/BRICK_1A.PNG

F 100,100,100
C 135,206,235

1111111
10D00N1
1000001
10D0001
1111111
