NO ./textures/N/BRICK_2B.PNG
SO ./textures/S/BRICK_3B 12.41.24 AM.PNG
WE ./textures/W/BRICK_3D 12.41.24 AM 12.41.32 AM.PNG
EA ./textures/E/BRICK_1A.PNG

F 50,50,50
C 135,206,235

11111111111111111
100000000000000N1
10001111D11111001
10001000000001001
10001000000001001
10001111D11111001
10000000000000001
11111111111111111
